###################################################################################################
###################################################################################################
##################                                                  ###############################
###########                                                                               #########
#####                                                                                           ###
###                                                                                             ###
###                     ######                                                                  ###
###                     #######                                                             #######
###                 ############                                                            #######
####                                                ####                            ###############
####                                                ####                            ###############
###                                                                                  ##############
###                                                                             ###################
#####                                                                           ###################
#####                                                                               ###############
#####                                                                                   ###########
#######                                 ####                                            ###########
#######                                 ####                                               ########
#####                                   ####                                                #######
######                                                                                      #######
#####                                                       ####                            #######
#####                                                       ####                            #######
##              ##                                                                      ###########
#####                                                                                ##############
#####                                                                                 #############
#####                                                                                   ###########
#######                                 ####                                            ###########
#######                                 ####                                               ########
#####                                   ####                                                #######
######                                                                                      #######
#####                                                                                       #######
#####                                                                                       #######
##########                                                                              ###########
#########                                                                               ###########
#######                                                                                 ###########
######                                                                                  ###########
#######                                                                                 ###########
#####                                                                                 #############
############                                                                            ###########
#############                                                                       ###############
###############                         ######                              #######################
###############                         #########                       ###########################
################                ####################                    ###########################
#####                                                                               ###############
#####                                                                                   ###########
#######                                 ####                                            ###########
#######                                 ####                                               ########
#####                                   ####                                                #######
######                                                                                      #######
#####                                                       ####                            #######
#####                                                       ####                            #######
##              ##                                                                      ###########
#####                                                                                ##############
#####                                                                                 #############
#####                                                                                   ###########
#######                                 ####                                            ###########
#######                                 ####                                               ########
#####                                   ####                                                #######
######                                                                                      #######
#####                                                                                       #######
#####                                                                                       #######
##########                                                                              ###########
#########                                                                               ###########
#######                                                                                 ###########
######                                                                                  ###########
#######                                                                                 ###########
#####                                                                                 #############
############                                                                            ###########
#############                                                                       ###############
###############                         ######                              #######################
###############                         #########                       ###########################
################                ####################                    ###########################
#################               ####################                    ###########################
#################               ####################                    ###########################
#################               ####################                    ###########################
#################               #####################                   ###########################
##################             ######################                  ############################
##################             #######################              ###############################
###################         ###########################            ################################
###################         ##########################              ###############################
###################         ##########################              ###############################
###################         ##########################              ###############################
###################         ##########################              ###############################
###################         ##########################              ###############################
###################         ##########################              ###############################
###################             #######################             ###############################
##################               ####################               ###############################
#################                 #################                   #############################
###############                     #############                     #############################
#############                        ###########                      #############################
############                           #######                            #########################
############                           #######                            #########################
############                           #######                            #########################
##############                                                          ###########################
###############                                                          ##########################
##################                                                     ############################
#####################                                                ##############################
###############################                               #####################################
###################################################################################################
###################################################################################################